#####################
###############  ####
##  !######       ###
#### ###          !##
##                ###
##        A        ##
#   !              ##
#####              ##
####    ##        ###
##             !  ###
##    B          ####
##       ### ### ####
##  #    !       ####
##  ###   ###########
##  !####   #########
#########        !###
#####!      ###  ####
#####################
