#####################
#!############# !####
##  #######       ###
#### ###  !       ###
##                ###
##        EFGH     ##
#   !     IABR     ##
#####     LCDK     ##
####    ! MNOP!   ###
##!               ###
##               ####
##       ##! ### ####
##  #            ####
##  ###   ###########
##  !####   #########
#########       #####
#####!      ### !####
#####################
